25 25
2 3 2 2 2 2 2 2 2 2 2 2 2 2 3 2 2 23 0 0 0 0 0 0 0
2 2 2 2 2 3 2 2 2 2 2 2 2 2 2 4 2 23 0 0 0 0 0 0 0
1 1 1 1 1 1 1 1 1 1 1 1 1 1 1 1 1 23 0 0 0 0 0 0 0
1 1 1 1 1 1 1 1 1 1 1 1 1 1 1 1 1 23 0 0 0 0 0 0 0
1 1 1 1 1 1 1 1 1 1 1 1 1 1 1 1 1 23 0 0 0 0 0 0 0
23 23 23 23 23 23 23 1 1 1 23 23 23 23 23 23 23 23 0 0 0 0 0 0 0
0 0 0 0 0 0 23 1 1 1 23 0 0 0 0 0 0 0 0 0 0 0 0 0 0
0 0 0 0 0 0 23 1 1 1 23 0 0 0 0 0 0 0 0 0 0 0 0 0 0
0 0 0 0 0 0 23 1 1 1 -1 0 0 0 0 0 0 0 0 0 0 0 0 0 0
0 0 0 0 0 0 23 1 1 1 23 0 0 0 0 0 0 0 0 0 0 0 0 0 0
0 0 0 0 0 0 23 1 1 1 23 0 0 0 0 0 0 0 0 0 0 0 0 0 0
0 0 0 0 0 0 -1 1 1 1 23 0 0 0 0 0 0 0 0 0 0 0 0 0 0
0 0 0 0 0 0 23 1 1 1 23 0 0 0 0 0 0 0 0 0 0 0 0 0 0
0 0 0 0 0 0 23 1 1 1 23 0 0 0 0 0 0 0 0 0 0 0 0 0 0
0 0 0 0 0 0 23 1 1 1 -1 0 0 0 0 0 0 0 0 0 0 0 0 0 0
0 0 0 0 0 0 23 1 1 1 23 0 0 0 0 0 0 0 0 0 0 0 0 0 0
0 0 0 0 0 0 23 1 1 1 23 0 0 0 0 0 0 0 0 0 0 0 0 0 0
0 0 0 0 0 0 23 23 23 23 23 0 0 0 0 0 0 0 0 0 0 0 0 0 0
0 0 0 0 0 0 0 0 0 0 0 0 0 0 0 0 0 0 0 0 0 0 0 0 0
0 0 0 0 0 0 0 0 0 0 0 0 0 0 0 0 0 0 0 0 0 0 0 0 0
0 0 0 0 0 0 0 0 0 0 0 0 0 0 0 0 0 0 0 0 0 0 0 0 0
0 0 0 0 0 0 0 0 0 0 0 0 0 0 0 0 0 0 0 0 0 0 0 0 0
0 0 0 0 0 0 0 0 0 0 0 0 0 0 0 0 0 0 0 0 0 0 0 0 0
0 0 0 0 0 0 0 0 0 0 0 0 0 0 0 0 0 0 0 0 0 0 0 0 0
0 0 0 0 0 0 0 0 0 0 0 0 0 0 0 0 0 0 0 0 0 0 0 0 0