17 17
2 3 2 2 2 2 2 2 2 2 2 2 2 2 3 2 2
2 2 2 2 2 3 2 2 2 2 2 2 2 2 2 4 2
0 0 0 0 0 0 0 1 0 0 0 0 25 0 1 1 1
0 0 0 0 0 0 0 0 0 0 0 0 25 0 1 1 1
0 0 0 1 0 0 0 0 0 0 0 1 25 0 1 1 1
0 0 0 0 1 1 0 0 0 0 0 0 25 0 1 1 1
0 0 0 0 1 0 0 1 0 0 1 1 25 0 1 1 1
0 22 0 0 0 0 0 0 0 0 1 0 25 0 1 1 1
20 23 0 0 0 1 0 0 0 0 1 0 1 1 1 1 1
16 23 1 1 0 1 1 1 0 0 0 0 1 1 1 1 1
0 24 0 0 0 1 0 0 0 0 1 0 1 1 1 1 1
0 0 0 0 0 0 0 0 0 0 1 0 25 0 0 0 0
0 0 0 0 1 0 0 1 0 0 1 1 25 0 0 0 0
0 0 0 0 1 1 0 0 0 0 0 0 25 0 0 0 0
0 0 0 1 0 0 0 0 0 0 0 1 25 0 0 0 0
0 0 0 0 0 0 0 0 0 0 0 0 25 0 0 0 0
0 0 0 0 0 0 0 1 0 0 0 0 25 0 0 0 0