40 55
0 0 0 0 0 0 0 0 0 20 26 26 26 26 26 26 26 26 26 26 26 26 26 26 26 26 26 26 26 26 21 0 0 0 0 0 0 0 0 0
0 0 0 0 0 0 0 0 0 20 26 26 26 26 26 26 26 26 26 26 26 26 26 26 26 26 26 26 26 26 21 0 0 0 0 0 0 0 0 0
0 0 0 0 0 0 0 0 0 36 38 38 38 38 38 38 38 38 38 38 38 38 38 38 38 38 38 38 38 38 37 0 0 0 0 0 0 0 0 0
0 0 0 0 0 0 0 0 0 39 41 41 41 41 41 41 41 41 41 41 41 41 41 41 41 41 41 41 41 41 40 0 0 0 0 0 0 0 0 0
0 0 0 0 0 0 0 0 0 39 41 41 41 41 41 41 41 41 41 41 41 41 41 41 41 41 41 41 41 41 40 0 0 0 0 0 0 0 0 0
0 0 0 0 0 0 0 0 0 39 41 41 41 41 41 41 41 41 41 41 41 41 41 41 41 41 41 41 41 41 40 0 0 0 0 0 0 0 0 0
0 0 0 0 0 0 0 0 0 39 41 41 41 41 41 41 41 41 41 41 41 41 41 41 41 41 41 41 41 41 40 0 0 0 0 0 0 0 0 0
0 0 0 0 0 0 0 0 0 39 41 41 41 41 41 41 41 41 41 41 41 41 41 41 41 41 41 41 41 41 40 0 0 0 0 0 0 0 0 0
0 0 0 0 0 0 0 0 0 39 41 41 41 41 41 41 41 41 41 41 41 41 41 41 41 41 41 41 41 41 40 0 0 0 0 0 0 0 0 0
0 0 0 0 0 0 0 0 0 39 41 41 41 41 41 41 41 41 41 41 41 41 41 41 41 41 41 41 41 41 40 0 0 0 0 0 0 0 0 0
0 0 0 0 0 0 0 0 0 39 41 41 41 41 41 41 41 41 41 41 41 41 41 41 41 41 41 41 41 41 40 0 0 0 0 0 0 0 0 0
0 0 0 0 0 0 0 0 0 39 41 41 41 41 41 41 41 41 41 41 41 41 41 41 41 41 41 41 41 41 40 0 0 0 0 0 0 0 0 0
0 0 0 0 0 0 0 0 0 39 41 41 41 41 41 41 41 41 41 41 41 41 41 41 41 41 41 41 41 41 40 0 0 0 0 0 0 0 0 0
0 0 0 0 0 0 0 0 0 39 41 41 41 41 41 41 41 41 41 41 41 41 41 41 41 41 41 41 41 41 40 0 0 0 0 0 0 0 0 0
0 0 0 0 0 0 0 0 0 42 41 41 41 41 44 41 44 41 41 41 41 41 41 41 41 41 41 41 41 41 43 0 0 0 0 0 0 0 0 0
0 0 0 0 0 0 14 7 7 7 7 7 7 8 3 3 3 9 7 7 7 7 7 7 7 7 7 7 7 7 7 7 7 15 0 0 0 0 0 0
0 0 0 0 0 0 4 3 3 3 3 3 3 3 3 3 3 3 3 3 3 3 3 3 3 3 3 3 3 3 3 3 3 5 0 0 0 0 0 0
0 0 0 0 0 0 4 3 3 3 3 3 3 3 3 3 3 3 3 3 3 3 3 3 3 3 3 3 3 3 3 3 3 5 0 0 0 0 0 0
0 0 0 0 0 0 4 3 3 3 3 3 3 3 3 3 3 3 3 3 3 3 3 3 3 3 3 3 3 3 3 3 3 5 0 0 0 0 0 0
0 0 0 0 0 0 4 3 3 3 3 3 3 3 3 3 3 3 3 3 3 3 3 3 3 3 3 3 3 3 3 3 3 5 0 0 0 0 0 0
0 0 0 0 0 0 4 3 3 3 3 3 3 3 3 3 3 3 3 3 3 3 3 3 3 3 3 3 3 3 3 3 3 5 0 0 0 0 0 0
0 0 0 0 0 0 16 27 27 27 27 27 27 27 27 18 4 3 3 3 3 3 3 5 16 27 27 27 27 27 27 27 27 18 0 0 0 0 0 0
0 0 0 0 0 0 20 26 26 26 26 26 26 26 26 21 4 3 3 3 3 3 3 5 20 26 26 26 26 26 26 26 26 21 0 0 0 0 0 0
0 0 0 0 0 0 20 26 26 26 26 26 26 26 26 21 4 3 3 3 3 3 3 5 20 26 26 26 26 26 26 26 26 21 0 0 0 0 0 0
0 0 0 0 0 0 20 26 26 26 26 26 26 26 26 21 4 3 3 3 3 3 3 5 20 26 26 26 26 26 26 26 26 21 0 0 0 0 0 0
0 0 0 0 0 0 20 26 26 26 26 26 26 26 26 21 4 3 3 3 3 3 3 5 20 26 26 26 26 26 26 26 26 21 0 0 0 0 0 0
0 0 0 0 0 0 20 26 26 26 26 26 26 26 26 21 4 3 3 3 3 3 3 5 20 26 26 26 26 26 26 26 26 21 0 0 0 0 0 0
0 0 0 0 0 0 20 26 26 26 26 26 26 26 26 21 4 3 3 3 3 3 3 5 20 26 26 26 26 26 26 26 26 21 0 0 0 0 0 0
0 0 0 0 0 0 20 26 26 26 26 26 26 26 26 21 4 3 3 3 3 3 3 5 20 26 26 26 26 26 26 26 26 21 0 0 0 0 0 0
0 0 0 0 0 0 20 26 26 26 26 26 26 26 26 21 4 3 3 3 3 3 3 5 20 26 26 26 26 26 26 26 26 21 0 0 0 0 0 0
0 0 0 0 0 0 20 26 26 26 26 26 26 26 26 21 4 3 3 3 3 3 3 5 20 26 26 26 26 26 26 26 26 21 0 0 0 0 0 0
0 0 0 0 0 0 20 26 26 26 26 26 26 26 26 21 4 3 3 3 3 3 3 5 20 26 26 26 26 26 26 26 26 21 0 0 0 0 0 0
0 0 0 0 0 0 20 26 26 26 26 26 26 26 26 21 4 3 3 3 3 3 3 5 20 26 26 26 26 26 26 26 26 21 0 0 0 0 0 0
0 0 0 0 0 0 20 26 26 26 26 26 26 26 26 21 4 3 3 3 3 3 3 5 20 26 26 26 26 26 26 26 26 21 0 0 0 0 0 0
0 0 0 0 0 0 20 26 26 26 26 26 26 26 26 21 4 3 3 3 3 3 3 5 20 26 26 26 26 26 26 26 26 21 0 0 0 0 0 0
0 0 0 0 0 0 20 26 26 26 26 26 26 26 26 21 4 3 3 3 3 3 3 5 20 26 26 26 26 26 26 26 26 21 0 0 0 0 0 0
0 0 0 0 0 0 20 26 26 26 26 26 26 26 26 21 4 3 3 3 3 3 3 5 20 26 26 26 26 26 26 26 26 21 0 0 0 0 0 0
0 0 0 0 0 0 20 26 26 26 26 26 26 26 26 21 4 3 3 3 3 3 3 5 20 26 26 26 26 26 26 26 26 21 0 0 0 0 0 0
0 0 0 0 0 0 20 26 26 26 26 26 26 26 26 21 4 3 3 3 3 3 3 5 20 26 26 26 26 26 26 26 26 21 0 0 0 0 0 0
0 0 0 0 0 0 19 28 28 28 28 28 28 28 28 17 4 3 3 3 3 3 3 5 19 28 28 28 28 28 28 28 28 17 0 0 0 0 0 0
0 0 0 0 0 0 22 29 29 29 29 29 29 29 29 23 4 3 3 3 3 3 3 5 22 29 29 29 29 29 29 29 29 23 0 0 0 0 0 0
0 0 0 0 0 0 30 29 29 35 29 29 35 29 29 31 4 3 3 3 3 3 3 5 30 29 29 35 29 29 35 29 29 31 0 0 0 0 0 0
0 0 0 0 0 0 22 29 29 29 29 29 29 29 29 23 4 3 3 3 3 3 3 5 22 29 29 29 29 29 29 29 29 23 0 0 0 0 0 0
0 0 0 0 0 0 30 29 29 35 29 29 35 29 29 31 4 3 3 3 3 3 3 5 30 29 29 35 29 29 35 29 29 31 0 0 0 0 0 0
0 0 0 0 0 0 22 29 29 29 29 29 29 29 29 23 4 3 3 3 3 3 3 5 22 29 29 29 29 29 29 29 29 23 0 0 0 0 0 0
0 0 0 0 0 0 30 29 29 35 29 29 35 29 29 31 4 3 3 3 3 3 3 5 30 29 29 35 29 29 35 29 29 31 0 0 0 0 0 0
0 0 0 0 0 0 22 29 29 29 29 29 29 29 29 23 4 3 3 3 3 3 3 5 22 29 29 29 29 29 29 29 29 23 0 0 0 0 0 0
0 0 0 0 0 0 30 29 29 35 29 29 35 29 29 31 4 3 3 3 3 3 3 5 30 29 29 35 29 29 35 29 29 31 0 0 0 0 0 0
0 0 0 0 0 0 22 29 29 29 29 29 29 29 29 23 4 3 3 3 3 3 3 5 22 29 29 29 29 29 29 29 29 23 0 0 0 0 0 0
0 0 0 0 0 0 30 29 29 35 29 29 35 29 29 31 4 3 3 3 3 3 3 5 30 29 29 35 29 29 35 29 29 31 0 0 0 0 0 0
0 0 0 0 0 0 22 29 29 29 29 29 29 29 29 23 4 3 3 3 3 3 3 5 22 29 29 29 29 29 29 29 29 23 0 0 0 0 0 0
0 0 0 0 0 0 30 29 29 35 29 29 35 29 29 31 4 3 3 3 3 3 3 5 30 29 29 35 29 29 35 29 29 31 0 0 0 0 0 0
0 0 0 0 0 0 22 29 29 29 29 29 29 29 29 23 4 3 3 3 3 3 3 5 22 29 29 29 29 29 29 29 29 23 0 0 0 0 0 0
0 0 0 0 0 0 30 29 29 35 29 29 35 29 29 31 4 3 3 3 3 3 3 5 30 29 29 35 29 29 35 29 29 31 0 0 0 0 0 0
0 0 0 0 0 0 24 32 32 32 32 32 32 32 32 25 4 3 3 3 3 3 3 5 24 32 32 32 32 32 32 32 32 25 0 0 0 0 0 0