40 25
0 0 4 3 5 0 0 0 0 0 0 0 4 3 5 0 0 0 0 0 36 37 37 37 37 37 37 37 37 38 0 0 0 0 0 0 0 0 0 0
0 1 4 3 5 0 0 0 0 0 0 0 4 3 5 0 0 0 0 0 39 40 40 40 40 40 40 40 40 41 0 0 0 0 0 0 0 0 0 0
0 2 4 3 5 0 0 0 16 27 27 18 4 3 16 27 27 18 0 0 39 40 40 40 40 40 40 40 40 41 0 0 0 0 0 0 0 0 0 0
0 0 4 3 9 7 7 7 20 26 26 21 8 3 20 26 26 21 7 7 39 40 40 40 40 40 40 40 40 41 0 0 0 0 0 0 0 0 0 0
0 0 4 3 3 3 3 3 20 26 26 21 3 3 20 26 26 21 3 3 39 40 40 40 40 40 40 40 40 41 0 0 0 0 0 0 0 0 0 0
0 0 4 3 11 6 6 6 20 26 26 21 10 11 20 26 26 21 6 6 39 40 40 40 40 40 40 40 40 41 0 0 0 0 0 0 0 0 0 0
0 0 4 3 5 0 0 0 20 26 26 21 4 5 20 26 26 21 0 0 39 40 40 40 40 40 40 40 40 41 0 0 0 0 0 0 0 0 0 0
0 0 4 3 5 0 0 0 20 26 26 21 4 5 20 26 26 21 0 0 39 40 40 40 40 40 40 40 40 41 0 0 0 0 0 0 0 0 0 0
0 0 4 3 5 0 0 0 20 26 26 21 4 5 20 26 26 21 0 0 42 44 44 44 43 43 44 44 44 45 0 0 0 0 0 0 0 0 0 0
0 0 4 3 5 0 0 0 20 26 26 21 4 5 20 26 26 21 0 0 0 0 0 0 0 0 0 4 3 5 0 0 0 0 0 0 0 0 0 0
0 0 4 3 5 0 0 0 20 26 26 21 4 5 20 26 26 21 0 0 0 0 0 0 0 0 0 4 3 5 0 0 0 0 0 0 0 0 0 0
0 0 4 3 5 0 0 0 19 28 28 17 4 5 19 28 28 17 0 0 0 0 0 0 0 0 0 4 3 5 0 0 0 0 0 0 0 0 0 0
0 0 4 3 5 0 0 0 22 29 29 23 4 5 22 29 29 23 0 0 0 0 0 0 0 0 1 4 3 5 0 0 0 0 0 0 0 0 0 0
0 0 4 3 5 0 0 0 30 29 35 31 4 5 30 35 29 31 0 0 0 0 0 0 0 0 2 4 3 5 0 0 0 0 0 0 0 0 0 0
0 0 4 3 5 0 0 0 22 29 29 23 4 5 22 29 29 23 0 0 0 0 0 0 0 0 0 4 3 5 0 0 0 0 0 0 0 0 0 0
0 0 4 3 5 0 0 0 30 35 29 31 4 5 30 29 35 31 0 0 0 0 0 0 0 0 0 4 3 5 0 0 0 0 0 0 0 0 0 0
0 0 4 3 5 0 0 0 22 29 29 23 4 5 22 29 29 23 0 0 0 0 0 0 0 0 0 4 3 5 0 0 0 0 0 0 0 0 0 0
0 0 4 3 5 0 0 0 33 32 32 34 4 5 33 32 32 34 0 0 0 0 0 0 0 0 0 4 3 5 0 0 0 0 0 0 0 0 0 0
0 0 4 3 9 7 7 7 7 7 7 7 8 9 7 7 7 7 7 7 7 7 7 7 7 7 7 8 3 5 0 0 0 0 0 0 0 0 0 0
0 0 4 3 3 3 3 3 3 3 3 3 3 3 3 3 3 3 3 3 3 3 3 3 3 3 3 3 3 5 0 0 0 0 0 0 0 0 0 0
0 0 12 6 6 6 6 6 6 6 6 6 6 6 6 6 6 6 6 6 6 6 6 6 6 6 6 10 3 5 0 0 0 0 0 0 0 0 0 0
0 0 0 0 0 0 0 0 0 0 0 0 0 0 0 0 0 0 0 0 0 0 0 0 0 0 1 4 3 5 0 0 0 0 0 0 0 0 0 0
0 0 0 0 0 0 0 0 0 0 0 0 0 0 0 0 0 0 0 0 0 0 0 0 0 0 2 4 3 5 0 0 0 0 0 0 0 0 0 0
0 0 0 0 0 0 0 0 0 0 14 7 7 7 7 7 7 7 7 7 7 7 7 7 7 7 7 8 3 5 0 0 0 0 0 0 0 0 0 0
0 0 0 0 0 0 0 0 0 0 4 3 3 3 3 3 3 3 3 3 3 3 3 3 3 3 3 3 3 5 0 0 0 0 0 0 0 0 0 0