38 36
16 16 0 16 16 0 16 16 16 16 8 16 16 4 5 16 16 17 16 9 9 9 9 9 9 16 16 16 16 16 4 5 16 16 16 16 16 17
16 16 16 16 16 16 16 16 16 2 8 16 16 16 16 16 17 16 9 9 16 16 2 16 16 9 9 16 16 16 16 2 16 17 17 17 17 16
0 16 0 0 16 0 0 0 16 16 8 8 10 16 16 17 7 16 9 16 16 16 6 16 16 16 9 16 16 16 16 16 16 0 0 0 0 16
16 0 16 16 0 16 0 16 16 0 8 8 11 16 16 17 17 16 9 16 16 16 16 16 16 16 16 9 16 0 0 0 0 16 16 16 0 16
16 16 0 16 16 16 16 0 16 16 8 16 17 17 17 16 16 9 9 16 17 16 17 16 16 16 16 9 16 0 0 0 16 16 16 16 0 16
16 16 12 13 16 0 17 17 17 8 8 17 16 17 17 16 9 9 17 16 16 16 1 3 16 0 0 9 9 0 16 0 0 16 16 16 16 16
16 6 14 15 16 16 17 16 17 17 8 16 17 17 16 16 9 16 17 16 16 16 18 19 16 16 0 6 9 9 0 16 16 0 0 7 0 16
16 16 16 16 16 17 17 17 17 17 8 17 6 16 16 9 9 16 17 16 0 0 16 16 16 16 16 0 0 9 9 16 16 16 0 0 6 16
16 0 16 1 3 17 17 17 16 16 8 16 16 16 9 9 16 16 17 16 16 16 16 16 16 16 16 0 16 16 9 9 16 16 16 0 0 16
16 16 16 18 19 17 17 17 16 16 8 16 16 16 9 16 2 16 17 17 16 16 16 17 17 16 0 0 16 16 16 9 9 16 0 16 0 16
10 16 16 16 16 16 16 16 16 16 8 8 16 9 16 16 16 16 16 10 16 16 16 17 16 16 16 16 0 16 16 16 9 9 9 16 0 16
11 16 2 16 16 16 16 16 6 7 16 8 9 16 16 16 16 16 16 11 16 16 17 17 16 16 16 16 16 16 16 0 16 16 9 17 17 17
16 16 16 16 16 16 16 16 16 16 9 9 9 16 2 16 16 16 7 16 17 17 17 16 16 16 16 16 0 0 17 17 17 17 9 9 16 16
16 16 16 16 16 16 16 16 16 9 9 8 16 16 16 16 16 16 16 16 16 16 16 16 16 16 16 16 16 0 0 0 0 0 16 16 9 9
16 16 17 16 16 16 16 16 9 9 16 8 16 16 16 16 16 16 16 16 16 0 0 16 0 16 16 0 16 0 0 16 0 16 16 2 16 9
16 16 16 16 16 16 16 16 9 16 16 8 16 16 12 13 16 16 16 0 0 16 0 0 0 16 16 0 0 16 16 16 0 0 0 0 16 16
7 16 16 16 16 6 16 16 9 2 16 8 8 16 14 15 16 16 0 17 17 16 6 16 16 0 0 0 0 0 0 16 0 16 16 16 16 9
16 16 16 16 16 16 16 9 16 16 16 16 8 16 16 16 16 16 16 16 17 17 17 17 16 16 16 16 16 16 0 16 0 16 16 16 16 9
16 16 16 16 16 16 9 9 16 16 16 6 8 8 16 16 16 16 16 16 16 16 16 17 17 16 16 16 16 16 16 16 0 12 13 16 9 16
16 16 1 3 16 16 9 16 17 16 16 16 16 8 16 16 16 16 16 16 16 16 16 16 17 17 16 16 16 16 16 16 0 14 15 16 9 16
16 16 17 17 16 16 9 16 16 16 16 16 16 8 16 16 16 17 1 3 17 16 16 16 16 17 0 0 16 0 16 0 16 0 16 9 0 16
16 16 2 17 16 16 9 16 16 16 16 16 16 8 17 17 16 17 18 19 17 16 16 16 2 17 16 16 16 16 16 16 0 16 9 16 0 16
16 16 0 16 16 16 9 9 16 16 16 16 8 16 16 16 16 17 17 17 17 17 0 16 16 17 17 16 16 17 17 17 17 16 9 16 0 16
16 16 0 16 16 16 9 9 16 17 17 17 8 17 17 17 17 17 17 17 17 16 0 0 16 16 17 17 17 16 16 16 0 9 17 17 17 17
16 16 0 0 0 0 9 17 17 16 16 16 16 16 16 16 17 17 17 17 16 16 16 0 0 0 0 0 0 0 16 0 9 9 16 0 16 10
16 16 16 16 0 0 9 17 17 17 17 8 17 16 16 16 17 17 17 0 0 16 16 16 10 16 16 16 7 0 0 9 9 16 16 16 16 11
16 16 16 0 0 17 9 16 16 16 17 17 17 16 17 17 17 17 0 0 16 16 16 16 11 16 16 0 0 6 9 9 16 16 0 16 16 16
12 13 16 0 0 9 9 16 16 16 8 16 17 16 16 16 16 0 0 16 16 16 2 16 16 16 0 0 9 9 9 17 0 16 16 16 16 16
14 15 16 16 16 9 16 16 16 16 8 8 8 8 8 16 16 0 16 16 16 16 16 16 16 16 16 9 9 16 17 17 0 16 16 16 16 16
16 16 16 16 9 9 16 16 16 8 16 16 16 16 16 8 8 8 16 16 16 16 17 17 17 9 9 0 0 17 17 0 0 16 0 16 0 0
16 16 9 9 16 16 16 16 8 8 16 16 7 16 16 16 16 8 8 8 16 16 17 16 9 16 17 16 0 0 0 16 0 16 0 0 16 16
9 9 16 16 16 16 16 8 8 16 16 16 16 16 16 16 16 16 16 16 8 8 9 16 16 0 17 0 0 16 16 16 16 16 16 16 16 16
9 16 0 0 0 16 16 8 16 2 16 16 16 16 0 16 16 16 16 17 16 8 8 8 8 16 16 17 16 16 16 16 16 16 16 16 16 16
16 0 0 16 16 16 8 8 16 16 16 17 16 16 16 16 16 16 16 16 9 16 16 0 0 8 16 8 16 6 16 2 16 16 16 17 17 16
16 0 16 16 16 8 8 16 16 0 0 16 16 16 16 16 16 16 9 16 16 16 0 0 16 16 16 17 17 8 16 17 16 17 16 16 16 16
17 16 16 16 16 8 16 16 16 16 0 0 16 16 16 16 9 9 9 16 16 16 16 7 16 16 16 16 16 16 8 8 1 3 16 16 16 16