20 20
16 16 0 16 16 0 16 16 16 16 8 16 16 4 5 16 16 17 16 9
16 16 16 16 16 16 16 16 16 2 8 16 16 16 16 16 17 16 9 9
0 16 0 0 16 0 0 0 16 16 8 8 10 16 16 17 7 16 9 16
16 0 16 16 0 16 0 16 16 0 8 8 11 16 16 17 17 16 9 17
16 16 0 16 16 16 16 0 16 16 8 16 17 17 17 16 16 9 16 16
16 16 12 13 16 0 17 17 17 8 8 17 16 17 17 16 9 9 16 16
16 6 14 15 16 16 17 16 17 17 8 16 17 17 16 16 9 16 16 16
16 16 16 16 16 17 17 17 17 17 8 17 6 16 16 9 9 16 16 16
16 16 16 1 3 17 17 17 16 16 8 16 16 16 9 9 16 16 16 16
16 16 16 18 19 17 17 17 16 16 8 16 16 16 9 16 2 16 16 16
10 16 16 16 16 16 16 16 16 16 8 8 16 9 16 16 16 16 16 16
11 16 2 16 16 16 16 16 6 7 16 8 9 16 16 16 16 16 16 16
16 16 16 16 16 16 16 16 16 16 9 9 9 16 2 16 16 16 7 16
16 16 16 16 16 16 16 16 16 9 9 8 16 16 16 16 16 16 16 16
16 16 16 16 16 16 16 16 9 9 16 8 16 16 16 16 16 16 16 16
16 16 16 16 16 16 16 16 9 16 16 8 16 16 12 13 16 16 16 16
7 16 16 16 16 6 16 16 9 16 16 8 8 16 14 15 16 16 16 16
16 16 16 16 16 16 16 9 16 16 16 16 8 16 16 16 16 16 16 16
16 16 16 16 16 16 9 9 16 16 16 6 8 8 16 16 16 16 16 16
16 16 1 3 16 16 9 16 16 16 16 16 16 8 16 16 16 16 16 16