30 20
0 0 0 0 0 0 0 0 0 0 3 5 4 2 2 2 2 2 2 2 2 2 2 2 2 2 2 2 2 2
0 0 1 1 1 0 0 0 0 0 3 5 4 2 2 2 2 2 2 2 0 0 0 0 0 0 0 0 2 2
0 0 1 0 1 0 2 2 2 2 3 5 4 2 0 2 0 0 0 2 2 2 2 2 2 2 2 0 2 2
0 0 0 1 1 1 1 1 0 1 3 5 4 0 2 2 2 2 0 2 0 0 0 2 0 2 2 2 2 2
0 1 1 0 0 2 2 2 0 0 3 5 4 0 0 2 2 2 2 2 0 0 2 2 0 0 2 2 2 2
0 1 1 2 2 2 2 2 0 0 3 5 4 2 0 0 2 2 2 0 0 2 2 2 0 2 2 2 2 2
0 0 1 2 2 2 2 2 1 1 3 5 4 2 0 0 2 0 0 0 2 2 2 0 2 0 2 2 2 2
0 0 0 2 2 0 1 1 0 0 3 5 4 1 2 0 0 2 2 2 2 2 2 2 2 2 2 2 2 2
0 0 0 2 0 0 1 1 2 0 3 5 4 1 1 0 0 1 1 1 1 2 1 1 1 1 1 1 2 2
0 1 0 0 0 0 0 0 2 0 3 5 4 1 1 1 0 0 0 1 1 2 1 1 2 1 2 1 1 2
1 1 0 0 0 1 2 1 1 1 3 5 4 2 2 2 0 0 0 0 1 2 1 1 2 1 1 2 2 2
0 2 2 0 0 1 1 1 1 1 3 5 4 2 1 1 0 1 1 0 1 2 1 1 1 1 1 2 2 2
0 2 1 0 0 1 2 1 0 0 3 5 4 0 1 2 2 1 1 0 0 2 0 1 1 1 2 2 2 2
0 2 2 0 2 1 1 1 0 0 3 5 4 0 0 2 2 1 1 1 1 2 0 1 2 2 2 2 2 1
0 0 2 1 2 1 1 2 2 0 3 5 4 0 0 2 1 1 1 1 2 2 0 1 1 1 2 2 2 1
0 0 1 1 2 2 2 2 2 1 3 5 4 0 0 1 1 1 2 2 2 1 1 1 2 2 2 2 1 1
2 2 2 2 2 0 2 0 1 1 3 5 4 2 2 2 2 2 2 1 2 2 2 1 2 0 1 2 1 1
1 1 1 1 2 0 2 0 2 2 3 5 4 2 2 2 2 2 0 0 2 2 1 1 0 0 2 2 1 1
0 0 1 1 2 1 0 0 0 2 2 2 2 2 2 2 2 2 2 0 0 0 0 0 2 1 2 2 2 1
0 0 1 1 1 2 2 2 2 2 2 2 2 2 2 2 2 2 2 2 2 2 1 1 1 1 2 2 2 1