17 17
2 2 2 3 2 2 2 2 2 2 2 2 2 2 2 2 2
2 3 2 2 2 2 2 2 2 4 2 2 2 2 3 2 2
0 0 0 0 0 9 0 0 1 1 1 0 0 0 0 0 0
0 0 0 0 0 9 0 0 1 1 1 0 0 0 0 0 0
5 5 6 7 7 8 0 0 1 1 1 1 0 0 0 0 0
1 1 1 0 0 0 0 0 0 1 1 1 1 0 0 0 0
1 1 1 0 0 0 0 0 0 0 1 1 1 0 0 0 0
1 1 1 1 0 0 0 0 0 0 1 1 1 0 0 0 0
0 1 1 1 1 1 1 1 1 1 1 1 1 0 0 0 0
0 0 1 1 1 1 1 1 1 1 1 1 1 0 0 0 0
0 0 0 1 1 1 1 1 1 1 1 1 1 0 0 0 0
0 0 0 0 0 0 0 0 0 0 1 1 1 0 0 0 0
0 0 0 0 0 0 0 0 0 1 1 1 1 0 0 0 0
0 0 0 0 0 0 0 0 1 1 1 1 1 0 0 0 0
0 0 0 0 0 0 0 0 1 1 1 1 0 0 0 0 0
0 0 0 0 0 0 0 0 1 1 1 0 0 0 0 0 0
0 0 0 0 0 0 0 0 1 1 1 0 0 0 0 0 0