17 17
2 2 2 2 2 2 2 2 2 2 2 2 2 3 2 2 2
2 3 2 2 2 2 2 2 3 2 2 2 2 2 4 2 2
0 0 0 0 0 0 10 9 0 20 22 15 0 1 1 1 0
0 0 0 0 0 0 10 9 0 18 23 0 0 1 1 1 0
0 0 0 0 0 0 10 9 0 16 24 15 0 1 1 1 0
10 10 10 10 10 10 10 9 0 0 0 0 0 1 1 1 0
5 5 6 7 7 7 7 8 0 0 0 0 0 1 1 1 0
1 1 1 1 1 1 1 1 1 1 1 1 1 1 1 1 0
1 1 1 1 1 1 1 1 1 1 1 1 1 1 1 1 0
1 1 1 1 1 1 1 1 1 1 1 1 1 1 1 1 0
0 0 0 0 20 22 15 0 1 1 1 0 0 0 0 0 0
0 0 0 0 18 23 0 0 1 1 1 0 0 0 0 0 0
0 0 0 0 16 24 15 0 1 1 1 0 0 0 0 0 0
0 0 0 0 0 0 0 0 1 1 1 0 0 0 0 0 0
14 22 0 0 0 0 0 0 1 1 1 0 0 0 0 0 0
0 23 15 0 0 0 0 0 1 1 1 0 0 0 0 0 0
14 24 0 0 0 0 0 0 1 1 1 0 0 0 0 0 0