17 17
5 2 2 2 2 2 2 2 2 2 2 2 2 2 2 2 6
3 13 15 15 15 15 15 15 15 15 15 15 15 15 15 14 4
3 10 12 12 12 12 12 12 12 12 12 12 12 12 12 11 4
3 10 12 12 12 12 12 12 12 12 12 12 12 12 12 11 4
3 0 0 0 0 0 0 0 0 0 0 0 0 0 0 0 4
3 0 0 0 0 0 0 0 0 0 0 0 0 0 0 0 4
3 0 0 0 0 0 0 0 0 0 0 0 0 0 0 0 4
3 0 0 0 0 0 0 0 0 0 0 0 0 0 0 0 4
3 0 0 0 0 0 0 0 0 0 0 0 0 0 0 0 4
3 0 0 0 0 0 0 0 0 0 0 0 0 0 0 0 4
3 0 0 0 0 0 0 0 0 0 0 0 0 0 0 0 4
3 0 0 0 0 0 0 0 0 0 0 0 0 0 0 0 4
3 0 0 0 0 0 0 0 0 0 0 0 0 0 0 0 4
3 0 0 0 0 0 0 0 0 0 0 0 0 0 0 0 4
3 0 0 0 0 0 0 0 0 0 0 0 0 0 0 0 4
7 1 1 1 1 1 1 9 9 9 1 1 1 1 1 1 8
-1 -1 -1 -1 -1 -1 -1 -1 -1 -1 -1 -1 -1 -1 -1 -1 -1