30 22
-1 -1 -1 -1 -1 -1 -1 -1 -1 -1 -1 -1 -1 -1 -1 -1 -1 -1 -1 -1 -1 -1 -1 -1 -1 -1 -1 -1 -1 -1
-1 -1 -1 -1 -1 -1 -1 -1 -1 -1 -1 -1 -1 -1 -1 -1 -1 -1 -1 -1 -1 -1 -1 -1 -1 -1 -1 -1 -1 -1
9 9 9 9 9 9 9 9 9 9 9 9 9 9 9 9 -1 -1 -1 -1 -1 -1 -1 -1 -1 -1 -1 -1 -1 -1
9 9 9 9 9 9 9 9 9 9 9 9 9 9 9 9 -1 -1 -1 -1 -1 -1 -1 -1 -1 9 -1 -1 -1 -1
9 9 9 9 9 9 9 9 9 9 9 9 9 9 9 9 9 9 9 9 9 9 9 9 9 9 9 -1 -1 -1
9 9 9 9 9 5 2 2 2 2 2 2 2 2 2 2 2 2 2 2 2 6 9 9 9 9 9 -1 -1 -1
9 9 9 9 9 3 13 15 15 15 15 15 15 15 15 15 15 15 15 15 14 4 9 9 9 9 9 -1 -1 -1
9 9 9 9 9 3 10 12 12 12 12 12 12 12 12 12 12 12 12 12 11 4 9 9 9 9 9 -1 -1 -1
9 9 9 9 9 3 10 12 12 12 12 12 12 12 12 12 12 12 12 12 11 4 9 9 9 9 9 -1 -1 -1
9 9 9 9 9 3 0 0 0 0 0 0 0 0 0 0 0 0 0 0 0 4 9 9 9 9 9 -1 -1 -1
9 9 9 9 9 3 0 0 0 0 0 0 0 0 0 0 0 0 0 0 0 4 9 9 9 9 9 -1 -1 -1
9 9 9 9 9 3 0 0 0 0 0 0 0 0 0 0 0 0 0 0 0 4 9 9 9 9 9 -1 -1 -1
9 9 9 9 9 3 0 0 0 0 0 0 0 0 0 0 0 0 0 0 0 4 9 9 9 9 9 -1 -1 -1
9 9 9 9 9 3 0 0 0 0 0 0 0 0 0 0 0 0 0 0 0 4 9 9 9 9 9 -1 -1 -1
9 9 9 9 9 3 0 0 0 0 0 0 0 0 0 0 0 0 0 0 0 4 9 9 9 9 9 -1 -1 -1
9 9 9 9 9 3 0 0 0 0 0 0 0 0 0 0 0 0 0 0 0 4 9 9 9 9 9 -1 -1 -1
9 9 9 9 9 3 0 0 0 0 0 0 0 0 0 0 0 0 0 0 0 4 9 9 9 9 9 -1 -1 -1
9 9 9 9 9 3 0 0 0 0 0 0 0 0 0 0 0 0 0 0 0 4 9 9 9 9 9 -1 -1 -1
9 9 9 9 9 3 0 0 0 0 0 0 0 0 0 0 0 0 0 0 0 4 9 9 9 9 9 -1 -1 -1
9 9 9 9 9 3 0 0 0 0 0 0 0 0 0 0 0 0 0 0 0 4 9 9 9 9 9 -1 -1 -1
9 9 9 9 9 7 1 1 1 1 1 1 9 9 9 1 1 1 1 1 1 8 9 9 9 9 9 -1 -1 -1
9 9 9 9 9 9 9 9 9 9 9 9 9 9 9 9 9 9 9 9 9 9 9 9 9 9 9 -1 -1 -1
