30 35
-1 -1 19 -1 -1 19 19 19 19 19 19 19 19 19 19 19 19 19 19 19 19 19 19 19 19 19 19 19 -1 -1
19 19 19 19 19 19 19 19 19 19 19 19 19 19 19 19 19 19 19 19 19 19 19 19 19 19 19 19 19 19
19 19 19 19 19 19 19 19 19 19 19 19 19 19 19 19 19 19 19 19 19 19 19 19 19 19 19 19 19 19
19 19 19 19 19 19 19 19 19 19 19 19 19 19 19 19 19 19 19 19 19 19 19 19 19 19 19 19 19 19
19 19 19 19 19 19 19 19 19 19 19 19 19 19 19 19 19 19 19 19 19 19 19 19 19 19 19 19 19 19
19 19 19 19 19 19 19 19 19 19 19 19 19 19 19 19 19 19 19 19 19 19 19 19 19 19 19 19 19 19
19 19 19 19 19 19 19 19 19 19 19 19 19 19 19 19 19 19 19 19 19 19 19 19 19 19 19 19 19 19
19 19 19 19 19 19 19 19 19 19 19 19 19 19 19 19 19 19 19 19 19 19 19 19 19 19 19 19 19 19
19 19 19 19 19 19 19 19 19 19 19 19 19 19 19 19 19 19 19 19 19 19 19 19 19 19 19 19 19 19
19 19 19 19 19 11 4 4 4 4 4 4 4 4 4 4 4 4 4 4 4 4 4 4 4 4 4 7 19 19
19 19 19 19 19 3 16 13 13 13 13 15 13 13 13 13 13 13 13 13 13 13 13 15 13 13 16 2 19 19
19 19 19 19 19 3 0 0 0 0 0 0 0 0 0 0 0 0 0 0 0 0 0 0 0 0 0 2 19 19
19 19 19 19 19 3 0 0 0 0 0 0 0 0 0 0 0 0 0 0 0 0 0 0 0 0 0 2 19 19
19 19 19 19 19 3 0 0 0 0 0 0 0 0 0 0 0 0 0 0 0 0 0 0 0 0 0 2 19 19
19 19 19 19 19 3 0 0 0 0 0 0 0 0 0 0 0 0 0 0 0 0 0 0 0 0 0 2 19 19
19 19 19 19 19 3 0 0 0 0 0 0 0 0 0 0 0 0 0 0 0 0 0 0 0 0 0 2 19 19
19 19 19 19 19 3 0 0 0 0 0 0 0 0 0 0 0 0 0 0 0 0 0 0 0 0 0 2 19 19
19 19 19 19 19 3 0 0 0 0 0 0 0 0 0 0 0 0 0 0 0 0 0 0 0 0 0 2 19 19
19 19 19 19 19 3 0 0 0 0 0 0 0 0 0 0 0 0 0 0 0 0 0 0 0 0 0 2 19 19
19 19 19 19 19 3 0 0 0 0 0 0 0 0 0 0 0 0 0 0 0 0 0 0 0 0 0 2 19 19
19 19 19 19 19 3 0 0 0 0 0 0 0 0 0 0 0 0 0 0 0 0 0 0 0 0 0 2 19 19
19 19 19 19 19 3 0 0 0 0 0 0 0 0 0 0 0 0 0 0 0 0 0 0 0 0 0 2 19 19
19 19 19 19 19 10 1 1 1 1 1 1 1 1 1 6 0 8 1 1 1 1 1 1 1 1 1 9 19 19
19 19 19 19 19 19 19 19 19 19 19 19 19 19 19 3 0 2 19 19 19 19 19 19 19 19 19 19 19 19
19 19 19 19 19 19 19 19 19 19 19 19 19 19 19 3 0 2 19 19 19 19 19 19 19 19 19 19 19 19
19 19 19 19 19 19 19 19 19 19 19 19 19 19 19 3 0 2 19 19 19 19 19 19 19 19 19 19 19 19
19 19 19 19 19 19 19 19 19 19 19 19 19 19 19 3 0 2 19 19 19 19 19 19 19 19 19 19 19 19
19 19 19 19 19 19 19 19 19 19 19 11 4 4 4 20 0 5 4 4 4 7 19 19 19 19 19 19 19 19
19 19 19 19 19 19 19 19 19 19 19 3 0 0 0 0 0 0 0 0 0 2 19 19 19 19 19 19 19 19
19 19 19 19 19 19 19 19 19 19 19 3 0 0 0 0 0 0 0 0 0 2 19 19 19 19 19 19 19 19
19 19 19 19 19 19 19 19 19 19 19 3 0 0 0 0 0 0 0 0 0 2 19 19 19 19 19 19 19 19
19 19 19 19 19 19 19 19 19 19 19 3 0 0 0 0 0 0 0 0 0 2 19 19 19 19 19 19 19 19
19 19 19 19 19 19 19 19 19 19 19 3 0 0 0 0 0 0 0 0 0 2 19 19 19 19 19 19 19 19
19 19 19 19 19 19 19 19 19 19 19 3 0 0 0 0 0 0 0 0 0 2 19 19 19 19 19 19 19 19
19 19 19 19 19 19 19 19 19 19 19 10 1 1 1 1 1 1 1 1 1 9 19 19 19 19 19 19 19 19