30 35
-1 -1 -1 -1 -1 -1 -1 -1 -1 -1 -1 -1 -1 -1 -1 -1 -1 -1 -1 -1 -1 -1 -1 -1 -1 -1 -1 -1 -1 -1
-1 -1 -1 -1 -1 -1 -1 -1 -1 -1 -1 -1 -1 -1 -1 -1 -1 -1 -1 -1 -1 -1 -1 -1 -1 -1 -1 -1 -1 -1
-1 -1 -1 -1 -1 -1 -1 -1 -1 -1 -1 -1 -1 -1 -1 -1 -1 -1 -1 -1 -1 -1 -1 -1 -1 -1 -1 -1 -1 -1
-1 -1 -1 -1 -1 -1 -1 -1 -1 -1 -1 -1 -1 -1 -1 -1 -1 -1 -1 -1 -1 -1 -1 -1 -1 -1 -1 -1 -1 -1
-1 -1 -1 -1 -1 -1 -1 -1 -1 -1 -1 -1 -1 -1 -1 -1 -1 -1 -1 -1 -1 -1 -1 -1 -1 -1 -1 -1 -1 -1
-1 -1 -1 -1 -1 -1 -1 -1 -1 -1 -1 -1 -1 -1 -1 -1 -1 -1 -1 -1 -1 -1 -1 -1 -1 -1 -1 -1 -1 -1
-1 -1 -1 -1 -1 -1 -1 -1 -1 -1 -1 -1 -1 -1 -1 -1 -1 -1 -1 -1 -1 -1 -1 -1 -1 -1 -1 -1 -1 -1
-1 -1 -1 -1 -1 -1 -1 -1 -1 -1 -1 -1 -1 -1 -1 -1 -1 -1 -1 -1 -1 -1 -1 -1 -1 -1 -1 -1 -1 -1
-1 -1 -1 -1 -1 -1 -1 -1 -1 -1 -1 -1 -1 -1 -1 -1 -1 -1 -1 -1 -1 -1 -1 -1 -1 -1 -1 -1 -1 -1
-1 -1 -1 -1 -1 -1 4 4 4 4 4 4 4 4 4 4 4 4 4 4 4 4 4 4 4 4 4 7 -1 -1
-1 -1 -1 -1 -1 -1 11 12 12 12 12 15 12 12 14 12 12 12 12 12 12 14 12 15 12 13 13 2 -1 -1
-1 -1 -1 -1 -1 3 0 0 0 0 0 0 0 0 0 0 0 0 0 0 0 0 0 0 0 0 0 2 -1 -1
-1 -1 -1 -1 -1 3 0 0 0 0 0 0 0 0 0 0 0 0 0 0 0 0 0 0 0 0 0 2 -1 -1
-1 -1 -1 -1 -1 3 0 0 0 0 0 0 0 0 0 0 0 0 0 0 0 0 0 0 0 0 0 2 -1 -1
-1 -1 -1 -1 18 3 0 0 0 0 0 0 0 0 0 0 0 0 0 0 0 0 0 0 0 0 0 2 -1 -1
18 18 18 18 18 3 0 0 0 0 0 0 0 0 0 0 0 0 0 0 0 0 0 0 0 0 0 2 -1 -1
18 18 18 18 18 3 0 0 0 0 0 0 0 0 0 0 0 0 0 0 0 0 0 0 0 0 0 2 -1 -1
18 18 18 18 18 3 0 0 0 0 0 0 0 0 0 0 0 0 0 0 0 0 0 0 0 0 0 2 18 18
18 18 18 18 18 3 0 0 0 0 0 0 0 0 0 0 0 0 0 0 0 0 0 0 0 0 0 2 18 18
18 18 18 18 18 3 0 0 0 0 0 0 0 0 0 0 0 0 0 0 0 0 0 0 0 0 0 2 18 18
18 18 18 18 18 3 0 0 0 0 0 0 0 0 0 0 0 0 0 0 0 0 0 0 0 0 0 2 18 18
18 18 18 18 18 3 0 0 0 0 0 0 0 0 0 0 0 0 0 0 0 0 0 0 0 0 0 2 18 18
18 18 18 18 18 18 1 1 1 1 1 1 1 1 6 0 0 0 18 18 18 18 18 18 18 18 18 18 18 18
18 18 18 18 18 18 18 18 18 18 18 18 18 18 3 0 0 0 2 18 18 18 18 18 18 18 18 18 18 18
18 18 18 18 18 18 18 18 18 18 18 18 18 18 3 0 0 0 2 18 18 18 18 18 18 18 18 18 18 18
18 18 18 18 18 18 18 18 18 18 18 18 18 18 3 0 0 0 2 18 18 18 18 18 18 18 18 18 18 18
18 18 18 18 18 18 18 18 18 18 18 18 18 18 3 0 0 0 2 18 18 18 18 18 18 18 18 18 18 18
18 18 18 18 18 18 18 18 18 18 18 10 4 4 3 0 0 0 5 4 4 7 18 18 18 18 18 18 18 18
-1 -1 -1 -1 -1 -1 -1 18 18 18 18 3 0 0 0 0 0 0 0 0 0 2 18 18 18 18 18 18 18 18
-1 -1 -1 -1 -1 -1 18 18 18 18 18 3 0 0 0 0 0 0 0 0 0 2 18 18 18 18 18 18 18 18
-1 -1 -1 -1 -1 -1 18 18 18 18 18 3 0 0 0 0 0 0 0 0 0 2 18 18 18 18 18 18 18 18
-1 -1 -1 -1 -1 -1 -1 18 18 18 18 3 0 0 0 0 0 0 0 0 0 2 18 18 18 18 18 18 18 18
-1 -1 -1 -1 -1 -1 -1 18 18 18 18 3 0 0 0 0 0 0 0 0 0 2 18 18 18 18 18 18 18 18
-1 -1 -1 -1 -1 -1 -1 -1 -1 18 18 3 0 0 0 0 0 0 0 0 0 2 18 18 18 18 18 18 18 18
-1 -1 -1 -1 -1 -1 -1 -1 -1 18 18 9 1 1 1 1 1 1 1 1 1 8 18 18 18 18 18 18 18 18