50 50
0 0 0 0 0 0 0 0 0 7 7 7 7 7 7 7 7 7 7 7 7 7 7 7 7 7 7 7 7 7 7 0 0 0 5 0 0 7 7 7 7 7 7 7 7 7 7 7 7 7
0 0 0 0 0 0 0 0 0 7 7 7 7 7 7 7 7 7 7 7 7 7 7 7 7 7 7 7 7 7 7 0 0 0 5 0 0 0 0 7 7 7 7 7 7 7 7 7 7 7
0 0 0 0 0 0 0 0 7 48 48 7 7 7 7 7 7 7 7 7 7 7 48 7 7 7 7 7 7 7 0 0 0 5 3 5 5 0 0 0 0 7 7 7 7 7 7 7 7 7
0 0 0 0 0 0 0 0 0 0 7 7 39 40 41 7 7 7 7 7 7 7 7 7 7 7 7 7 7 7 0 0 0 5 4 5 5 5 5 0 0 0 7 48 7 7 7 7 7 7
0 0 0 0 0 0 0 0 0 0 0 7 42 43 44 7 7 7 7 7 7 7 7 7 7 7 7 7 7 0 0 0 5 5 5 5 6 5 5 0 0 0 7 7 7 7 7 7 7 7
0 0 0 0 0 0 0 0 0 0 0 7 45 46 47 7 7 7 7 7 7 7 9 10 11 12 7 7 7 8 0 8 5 6 5 5 5 5 0 0 0 0 7 7 7 7 7 7 7 7
0 0 0 0 0 0 8 8 0 2 0 7 1 1 1 7 7 7 7 7 7 48 13 14 15 16 7 7 8 2 8 8 8 8 5 5 3 5 0 0 0 0 7 7 7 7 7 7 48 7
0 0 0 0 0 8 8 8 8 0 0 0 0 1 1 1 7 7 7 7 7 7 17 18 19 20 7 7 8 49 50 51 8 8 5 5 4 5 0 0 0 0 7 7 7 7 7 7 7 7
0 0 0 0 8 8 2 8 8 0 0 0 0 0 7 1 1 7 7 7 7 7 21 22 23 24 7 8 8 52 53 54 2 8 6 5 5 0 0 0 0 7 7 7 7 7 7 7 7 7
0 0 0 0 8 8 49 50 51 0 0 0 0 0 48 48 1 1 7 7 1 7 25 26 27 28 7 8 8 55 56 57 8 8 0 0 0 0 0 0 0 7 7 7 7 7 7 7 7 7
0 0 0 0 0 8 52 53 54 0 0 0 0 0 7 7 1 1 7 7 7 7 29 30 31 32 7 8 8 8 58 8 8 0 0 0 0 0 0 0 7 7 7 7 7 7 7 7 7 7
0 0 0 2 0 0 55 56 57 0 0 0 0 0 7 7 1 7 7 7 33 34 1 1 1 1 7 8 8 8 58 8 8 0 0 0 0 0 0 0 7 7 7 7 7 7 7 7 7 7
0 0 0 0 0 0 0 58 0 0 0 0 0 0 0 7 7 1 7 7 36 37 1 1 1 1 1 2 8 8 58 8 8 0 0 0 0 0 0 7 7 48 7 7 7 7 7 7 7 7
0 0 0 0 0 0 0 58 0 0 0 5 0 0 2 7 1 7 7 7 7 1 1 1 1 1 7 7 8 8 59 8 8 0 0 0 0 0 0 7 7 7 7 7 7 7 7 7 7 7
0 0 0 0 0 0 0 58 0 0 5 3 5 0 0 7 1 7 48 33 34 35 1 1 1 1 33 34 35 8 8 8 0 0 0 0 0 0 7 7 7 7 7 7 7 7 48 7 7 7
0 0 0 0 0 0 0 59 0 5 5 4 5 0 0 7 1 1 7 42 38 44 7 1 1 1 42 43 44 7 7 0 0 0 0 0 0 0 7 7 7 7 7 7 7 7 7 7 7 7
0 0 0 0 0 0 0 0 0 0 5 5 5 0 0 7 1 1 7 45 46 37 1 1 1 1 45 46 47 7 7 7 0 0 0 7 7 7 7 7 7 7 7 7 7 7 7 7 7 7
0 0 0 0 0 0 0 0 0 0 0 0 0 0 7 7 7 1 1 1 7 1 1 1 1 1 7 7 7 7 7 7 7 7 7 7 7 7 48 7 7 7 7 7 7 7 7 7 7 7
0 0 0 7 48 7 7 0 0 0 0 0 7 7 7 7 7 7 7 1 1 7 1 1 1 1 7 1 7 7 7 7 7 7 7 7 7 7 7 7 7 7 7 7 7 7 7 7 7 7
0 0 7 7 7 7 7 7 7 7 7 7 7 7 7 7 7 7 7 7 33 34 1 1 1 1 39 40 41 7 7 7 7 7 7 7 7 7 7 7 7 7 7 7 7 7 7 7 7 7
0 7 7 7 7 7 7 7 7 7 7 7 7 7 7 7 7 7 7 7 36 47 1 1 1 1 45 46 47 7 7 7 7 7 7 7 7 7 7 7 7 7 7 7 7 7 7 7 7 7
7 7 7 7 7 7 5 5 7 7 7 7 7 7 7 7 7 7 1 7 7 7 1 1 1 1 1 1 7 7 7 7 7 7 7 7 7 7 7 7 7 7 7 7 7 7 7 7 7 7
7 7 7 7 7 7 5 3 5 5 5 7 7 7 7 7 7 7 7 7 1 7 1 1 1 7 7 7 7 1 7 7 7 7 7 7 7 7 7 7 7 7 7 7 7 7 7 7 7 7
7 7 7 7 7 5 5 4 5 5 5 5 7 7 7 7 7 7 33 34 35 1 1 1 1 1 1 7 7 7 7 7 7 7 7 7 7 7 7 7 7 7 7 7 7 7 7 7 7 7
7 7 7 7 7 5 5 5 5 5 6 5 7 7 7 7 7 7 42 38 44 1 1 1 7 7 7 1 7 1 7 7 7 7 7 7 7 7 7 7 7 7 7 7 7 7 7 7 7 7
7 7 7 7 7 3 5 5 5 5 5 7 7 7 7 7 7 7 42 43 44 1 1 7 7 7 7 7 7 7 7 7 7 7 7 7 7 7 7 7 7 7 7 7 7 7 7 7 7 7
7 7 7 7 7 4 5 5 3 5 7 7 7 7 7 7 7 7 45 46 47 1 1 1 7 7 1 7 7 7 1 7 7 7 7 7 7 7 7 7 7 7 7 7 7 7 7 7 7 7
7 7 7 7 7 5 5 5 4 7 7 7 7 7 7 7 7 7 7 7 7 7 7 7 7 7 7 7 1 7 7 7 7 7 7 7 7 7 7 7 7 7 7 7 7 7 7 7 7 7
7 7 7 7 7 5 5 5 5 7 7 7 7 7 7 7 7 7 7 7 7 1 7 7 7 7 7 7 7 1 7 7 7 7 7 7 7 7 7 7 7 7 7 7 7 7 7 7 7 7
7 7 7 48 7 5 7 7 7 7 48 7 7 7 7 7 7 7 7 7 7 7 48 7 7 7 7 7 7 7 7 7 7 7 7 7 7 7 7 7 7 7 7 48 7 7 7 7 7 7
7 7 7 7 7 7 7 7 7 7 7 7 7 7 7 7 7 7 7 7 7 7 7 7 7 7 7 7 7 7 7 7 7 7 7 7 7 7 7 7 7 7 7 7 7 7 7 7 7 7
7 7 7 7 7 7 7 7 7 7 7 7 7 7 7 7 7 7 7 7 7 7 7 7 7 7 7 7 7 7 7 7 7 7 7 7 7 7 7 7 7 7 7 7 7 7 7 7 7 7
7 7 7 7 7 7 7 7 7 7 7 7 7 7 7 7 7 7 7 7 7 7 7 7 7 7 7 7 7 7 7 7 7 7 7 7 7 7 7 7 7 7 7 7 7 7 7 7 7 7
7 7 7 7 7 7 7 7 7 7 7 7 7 7 7 7 7 7 7 7 7 7 7 7 7 7 7 7 7 7 7 7 7 7 7 7 7 7 7 7 7 7 7 7 7 7 7 7 7 7
7 7 7 7 7 7 7 7 7 7 7 7 7 7 7 7 7 7 7 7 7 7 7 7 7 7 7 7 7 7 7 7 7 7 7 7 7 7 7 7 7 7 7 7 7 7 7 7 7 7
7 7 7 7 7 7 7 7 7 7 7 7 7 7 7 7 7 7 7 7 7 7 7 7 7 7 7 7 7 7 7 7 7 7 7 7 7 7 7 7 7 7 7 7 7 7 7 7 7 7
7 7 7 7 7 7 7 7 7 7 7 7 7 7 7 7 7 7 7 7 7 7 7 7 7 7 7 7 7 7 7 7 7 7 7 7 7 7 7 7 7 7 7 7 7 7 7 7 7 7
7 7 7 7 7 7 7 7 7 7 7 7 7 7 7 7 7 7 7 7 7 7 7 7 7 7 7 7 7 7 7 7 7 7 7 7 7 7 7 7 7 7 7 7 7 7 7 7 7 7
7 7 7 7 7 7 7 7 7 7 7 7 7 7 7 7 7 7 7 7 7 7 7 7 7 7 7 7 7 7 7 7 7 7 7 7 7 7 7 7 7 7 7 7 7 7 7 7 7 7
7 7 7 7 7 7 7 7 48 7 7 7 7 7 7 7 48 7 7 7 7 7 7 7 7 7 7 7 7 7 7 7 7 7 7 7 7 7 7 7 7 7 7 7 7 7 7 7 7 7
7 7 48 7 7 7 7 7 7 7 7 7 7 7 7 7 7 7 7 7 7 7 7 7 7 7 7 7 7 7 7 7 7 7 7 7 7 7 7 7 7 7 7 7 7 7 7 7 7 7
5 3 7 33 34 35 48 7 8 8 8 7 7 7 7 7 7 7 7 7 7 7 7 7 7 7 7 7 7 7 7 7 7 7 7 7 7 7 7 7 7 7 7 7 7 7 7 7 7 7
5 4 5 42 38 44 7 8 8 8 8 8 7 7 7 7 7 7 7 7 7 7 7 7 7 7 7 7 7 7 7 7 7 7 7 7 7 7 7 7 7 7 7 7 7 7 7 7 7 7
3 5 6 42 43 44 8 8 49 50 51 8 7 7 7 7 7 7 7 7 7 7 7 7 7 7 7 48 7 7 7 7 7 7 7 7 7 7 7 7 7 7 7 48 7 7 7 7 7 7
4 5 8 45 46 37 8 8 52 53 54 8 8 8 7 7 7 7 7 7 7 7 7 7 7 7 7 7 7 7 7 7 7 7 7 7 7 7 7 7 7 7 7 7 7 7 7 7 7 7
5 8 8 8 8 8 2 8 55 56 8 8 2 8 7 7 7 7 7 7 7 7 7 7 7 7 7 7 7 7 7 7 7 7 7 7 7 7 7 7 7 7 7 7 7 7 7 7 7 7
8 8 2 8 8 8 8 8 8 58 8 8 8 8 7 7 7 7 7 7 7 7 7 7 7 7 7 7 7 7 7 7 7 7 7 7 7 7 7 7 7 7 7 7 7 7 7 7 7 7
8 8 8 8 8 8 8 8 8 58 8 8 8 8 8 8 7 7 7 7 7 7 7 7 7 7 7 7 7 7 7 7 7 7 7 7 7 7 7 7 7 7 7 7 7 7 7 7 7 7
8 8 8 8 8 8 8 8 8 59 8 8 8 8 8 8 8 7 7 7 7 7 7 7 7 7 7 7 7 7 7 7 7 7 7 7 7 7 7 7 7 7 7 7 7 7 7 7 7 7
8 8 8 8 2 8 8 8 8 8 8 8 8 8 2 8 8 7 7 7 7 7 7 7 7 7 7 7 7 7 7 7 7 7 7 7 7 7 7 7 7 7 7 7 7 7 7 7 7 7