50 50
7 7 7 7 7 7 7 7 7 7 7 7 7 7 7 7 7 7 7 7 7 7 7 7 7 7 7 7 7 7 7 7 7 7 7 7 7 7 7 7 7 7 7 7 7 7 7 7 7 7
7 7 7 7 7 7 7 7 7 7 7 7 7 7 7 7 7 7 7 7 7 7 7 7 7 7 7 7 7 7 7 7 7 7 7 7 7 7 7 7 7 7 7 7 7 7 7 7 7 7
7 7 7 7 7 7 7 7 7 32 32 7 7 7 7 7 7 7 7 7 7 7 32 7 7 7 7 7 7 7 7 32 7 7 7 7 7 7 7 7 7 7 7 7 7 7 7 7 7 7
7 7 7 7 7 7 7 7 7 7 7 7 7 7 7 7 7 7 7 7 7 7 7 7 7 7 7 7 7 7 7 7 7 7 7 7 7 7 7 7 7 7 7 32 7 7 7 7 7 7
7 7 7 7 7 7 7 7 0 0 0 7 7 7 7 7 7 7 7 7 7 7 7 9 10 11 7 7 7 7 7 7 7 7 7 7 7 7 7 7 7 7 7 7 7 7 7 7 7 7
7 7 7 7 7 0 0 0 0 0 0 7 7 7 7 7 7 7 7 7 7 7 7 12 13 14 7 7 8 8 8 8 8 7 7 7 7 7 7 7 7 7 7 7 7 7 7 7 7 7
7 7 7 7 0 0 8 8 0 2 0 7 7 7 7 7 7 7 7 7 7 32 7 15 16 17 7 7 8 2 8 8 8 8 7 7 7 7 7 7 7 7 7 7 7 7 7 7 32 7
7 7 7 0 8 8 8 8 8 0 0 7 7 7 7 7 7 7 7 7 7 7 7 18 19 20 7 8 8 8 34 35 8 8 7 7 7 7 7 7 7 7 7 7 7 7 7 7 7 7
7 7 7 0 8 8 2 8 8 0 0 7 7 7 7 7 7 7 7 7 7 7 7 21 22 23 8 8 8 36 37 38 2 8 7 7 7 7 7 7 7 7 7 7 7 7 7 7 7 7
7 7 7 0 8 8 33 34 35 0 0 0 7 7 32 32 7 7 7 7 7 7 7 1 1 1 1 8 8 39 40 41 8 8 7 7 7 7 7 32 7 7 7 7 7 7 7 7 7 7
7 7 0 0 0 8 36 37 38 0 0 0 0 0 7 7 7 7 7 7 7 7 7 1 1 1 1 8 8 8 42 8 8 8 7 7 7 7 7 7 7 7 7 7 7 7 7 7 7 7
7 7 0 2 0 0 39 40 41 0 0 0 0 0 7 7 7 7 7 7 24 25 7 1 1 1 8 8 8 8 42 8 8 7 7 7 7 7 7 7 7 7 7 7 7 7 7 7 7 7
7 7 0 0 0 0 0 42 0 0 0 0 0 0 0 7 7 7 7 7 26 27 1 1 1 1 8 2 8 8 42 8 8 7 7 7 7 7 7 7 7 32 7 7 7 7 7 7 7 7
7 7 7 0 0 0 0 42 0 0 0 5 0 0 2 7 7 7 7 7 7 7 1 1 1 1 7 7 8 8 43 8 8 7 7 7 7 7 7 7 7 7 7 7 7 7 7 7 7 7
7 7 7 7 0 0 0 42 0 0 5 3 5 0 0 7 7 7 32 7 7 7 1 1 1 1 28 29 7 8 8 8 7 7 7 7 7 7 7 7 7 7 7 7 7 7 32 7 7 7
7 7 7 7 7 0 0 43 0 5 5 4 5 0 0 7 7 7 7 7 24 25 7 1 1 1 30 27 7 7 7 7 7 7 7 7 7 7 7 7 7 7 7 7 7 7 7 7 7 7
7 7 7 7 7 7 0 0 0 0 5 5 5 0 0 7 7 7 7 7 26 27 1 1 1 1 7 7 7 32 7 7 7 7 7 7 7 7 7 7 7 7 7 7 7 7 7 7 7 7
7 7 7 7 7 7 0 0 0 0 0 0 0 0 7 7 7 7 7 7 7 1 1 1 1 1 7 7 7 7 7 7 7 7 7 7 7 7 32 7 7 7 7 7 7 7 7 7 7 7
7 7 7 7 32 7 7 0 0 0 0 0 7 7 7 7 7 7 7 7 7 7 1 1 1 1 7 7 7 7 7 7 7 7 7 7 7 7 7 7 7 7 7 7 7 7 7 7 7 7
7 7 7 7 7 7 7 7 7 7 7 7 7 7 7 7 7 7 7 7 24 25 1 1 1 1 7 28 29 7 7 7 7 7 7 7 7 7 7 7 7 7 7 7 7 7 7 7 7 7
7 7 7 7 7 7 7 7 7 7 7 7 7 7 7 7 7 7 7 7 26 27 1 1 1 1 1 26 27 7 7 7 7 7 7 7 7 7 7 7 7 7 7 7 7 7 7 7 7 7
7 7 7 7 7 7 5 5 7 7 7 7 7 7 7 7 7 7 7 7 7 7 7 1 7 1 1 1 7 7 7 7 7 7 7 7 7 7 7 7 7 7 7 7 7 7 7 7 7 7
7 7 7 7 7 7 5 3 5 5 5 7 7 7 7 7 7 7 7 7 7 7 7 1 7 7 7 7 7 7 7 7 7 7 7 7 7 7 7 7 7 7 7 7 7 7 7 7 7 7
7 7 7 7 7 5 5 4 5 5 5 5 7 7 7 7 7 7 7 7 7 1 7 7 7 1 1 7 7 7 7 7 7 7 7 7 7 7 7 7 7 7 7 7 7 7 7 7 7 7
7 7 7 7 7 5 5 5 5 5 6 5 7 7 7 7 7 7 7 7 7 7 7 7 7 7 7 7 7 1 7 7 7 7 7 7 7 7 7 7 7 7 7 7 7 7 7 7 7 7
7 7 7 7 7 3 5 5 5 5 5 7 7 7 7 7 7 7 7 7 7 7 7 7 7 7 7 7 7 7 7 7 7 7 7 7 7 7 7 7 7 7 7 7 7 7 7 7 7 7
7 7 7 7 7 4 5 5 3 5 7 7 7 7 7 7 7 7 7 7 7 7 7 1 7 7 1 7 7 7 7 7 7 7 7 7 7 7 7 7 7 7 7 7 7 7 7 7 7 7
7 7 7 7 7 5 5 5 4 7 7 7 7 7 7 7 7 7 7 7 7 7 7 7 7 7 7 7 7 7 7 7 7 7 7 7 7 7 7 7 7 7 7 7 7 7 7 7 7 7
7 7 7 7 7 5 5 5 5 7 7 7 7 7 7 7 7 7 7 7 7 7 7 7 7 7 7 7 7 7 7 7 7 7 7 7 7 7 7 7 7 7 7 7 7 7 7 7 7 7
7 7 7 32 7 5 7 7 7 7 32 7 7 7 7 7 7 7 7 7 7 7 32 7 7 7 7 7 7 7 7 7 7 7 7 7 7 7 7 7 7 7 7 32 7 7 7 7 7 7
7 7 7 7 7 7 7 7 7 7 7 7 7 7 7 7 7 7 7 7 7 7 7 7 7 7 7 7 7 7 7 7 7 7 7 7 7 7 7 7 7 7 7 7 7 7 7 7 7 7
7 7 7 7 7 7 7 7 7 7 7 7 7 7 7 7 7 7 7 7 7 7 7 7 7 7 7 7 7 7 7 7 7 7 7 7 7 7 7 7 7 7 7 7 7 7 7 7 7 7
7 7 7 7 7 7 7 7 7 7 7 7 7 7 7 7 7 7 7 7 7 7 7 7 7 7 7 7 7 7 7 7 7 7 7 7 7 7 7 7 7 7 7 7 7 7 7 7 7 7
7 7 7 7 7 7 7 7 7 7 7 7 7 7 7 7 7 7 7 7 7 7 7 7 7 7 7 7 7 7 7 7 7 7 7 7 7 7 7 7 7 7 7 7 7 7 7 7 7 7
7 7 7 7 7 7 7 7 7 7 7 7 7 7 7 7 7 7 7 7 7 7 7 7 7 7 7 7 7 7 7 7 7 7 7 7 7 7 7 7 7 7 7 7 7 7 7 7 7 7
7 7 7 7 7 7 7 7 7 7 7 7 7 7 7 7 7 7 7 7 7 7 7 7 7 7 7 7 7 7 7 7 7 7 7 7 7 7 7 7 7 7 7 7 7 7 7 7 7 7
7 7 7 7 7 7 7 7 7 7 7 7 7 7 7 7 7 7 7 7 7 7 7 7 7 7 7 7 7 7 7 7 7 7 7 7 7 7 7 7 7 7 7 7 7 7 7 7 7 7
7 7 7 7 7 7 7 7 7 7 7 7 7 7 7 7 7 7 7 7 7 7 7 7 7 7 7 7 7 7 7 7 7 7 7 7 7 7 7 7 7 7 7 7 7 7 7 7 7 7
7 7 7 7 7 7 7 7 7 7 7 7 7 7 7 7 7 7 7 7 7 7 7 7 7 7 7 7 7 7 7 7 7 7 7 7 7 7 7 7 7 7 7 7 7 7 7 7 7 7
7 7 7 7 7 7 7 7 32 7 7 7 7 7 7 7 32 7 7 7 7 7 7 7 7 7 7 7 7 7 7 7 7 7 7 7 7 7 7 7 7 7 7 7 7 7 7 7 7 7
7 7 32 7 7 7 7 7 7 7 7 7 7 7 7 7 7 7 7 7 7 7 7 7 7 7 7 7 7 7 7 7 7 7 7 7 7 7 7 7 7 7 7 7 7 7 7 7 7 7
5 3 7 7 7 7 32 7 8 8 8 7 7 7 7 7 7 7 7 7 7 7 7 7 7 7 7 7 7 7 7 7 7 7 7 7 7 7 7 7 7 7 7 7 7 7 7 7 7 7
5 4 5 7 24 25 7 8 8 8 8 8 7 7 7 7 7 7 7 7 7 7 7 7 7 7 7 7 7 7 7 7 7 7 7 7 7 7 7 7 7 7 7 7 7 7 7 7 7 7
3 5 6 5 26 27 8 8 33 34 35 8 7 7 7 7 7 7 7 7 7 7 7 7 7 7 7 32 7 7 7 7 7 7 7 7 7 7 7 7 7 7 7 32 7 7 7 7 7 7
4 5 8 8 8 8 8 8 36 37 38 8 8 8 7 7 7 7 7 7 7 7 7 7 7 7 7 7 7 7 7 7 7 7 7 7 7 7 7 7 7 7 7 7 7 7 7 7 7 7
5 8 8 8 8 8 2 8 39 40 41 8 2 8 7 7 7 7 7 7 7 7 7 7 7 7 7 7 7 7 7 7 7 7 7 7 7 7 7 7 7 7 7 7 7 7 7 7 7 7
8 8 2 8 8 8 8 8 8 42 8 8 8 8 7 7 7 7 7 7 7 7 7 7 7 7 7 7 7 7 7 7 7 7 7 7 7 7 7 7 7 7 7 7 7 7 7 7 7 7
8 8 8 8 8 8 8 8 8 42 8 8 8 8 8 8 7 7 7 7 7 7 7 7 7 7 7 7 7 7 7 7 7 7 7 7 7 7 7 7 7 7 7 7 7 7 7 7 7 7
8 8 8 8 8 8 8 8 8 43 8 8 8 8 8 8 8 7 7 7 7 7 7 7 7 7 7 7 7 7 7 7 7 7 7 7 7 7 7 7 7 7 7 7 7 7 7 7 7 7
8 8 8 8 2 8 8 8 8 8 8 8 8 8 2 8 8 7 7 7 7 7 7 7 7 7 7 7 7 7 7 7 7 7 7 7 7 7 7 7 7 7 7 7 7 7 7 7 7 7