32 30
0 0 0 0 0 0 0 0 0 0 0 0 0 0 0 0 2 0 0 0 0 0 6 5 5 5 1 1 1 1 1 1
0 0 1 1 1 1 1 1 1 0 0 0 0 0 0 0 2 2 2 2 0 0 5 5 5 5 5 5 1 1 1 1
0 1 1 1 1 1 1 1 0 0 0 0 0 0 0 0 2 2 2 2 0 0 0 5 3 5 5 1 1 1 1 5
0 1 1 1 1 0 1 1 0 0 0 0 0 0 0 2 2 2 2 2 0 0 5 5 4 5 1 1 1 1 1 5
0 1 1 1 0 1 1 1 0 1 1 1 1 1 2 2 2 2 2 2 2 2 0 5 5 5 1 1 1 1 1 5
0 1 1 1 1 0 1 1 0 0 1 1 1 1 2 2 2 2 2 2 2 0 0 1 1 1 1 1 1 1 1 5
0 1 1 1 0 1 1 1 0 1 0 0 0 0 0 0 2 0 2 2 0 0 5 1 1 5 1 1 1 1 1 5
0 1 1 1 0 1 1 1 1 1 0 0 0 0 0 0 2 0 0 0 1 1 1 0 5 5 1 1 1 1 1 1
0 1 1 0 0 1 0 1 1 1 1 0 0 0 2 2 2 0 0 0 1 1 1 5 5 5 1 1 1 5 5 5
0 0 0 0 0 1 0 1 1 1 1 0 2 2 2 2 2 2 0 0 0 1 1 0 5 6 1 1 1 1 6 5
0 0 1 1 1 1 1 1 1 0 0 0 0 2 2 2 2 2 0 0 0 1 0 5 5 5 1 1 1 1 1 5
0 0 1 1 1 1 1 1 0 0 0 0 0 0 2 2 2 0 0 0 0 1 0 5 5 1 1 1 1 1 5 5
0 1 1 1 1 1 1 1 1 1 1 1 1 0 2 2 2 2 0 0 0 0 0 0 5 1 1 1 1 5 5 5
0 0 1 1 1 1 0 0 0 0 0 0 0 0 0 2 0 0 0 0 0 0 1 5 5 5 1 1 5 1 1 1
0 0 1 1 1 1 1 1 1 1 0 0 0 0 0 2 0 0 0 0 0 0 5 5 1 1 1 5 5 5 5 5
0 0 1 5 5 1 1 1 1 1 0 2 0 0 0 0 0 0 0 0 0 0 0 0 0 0 1 1 1 1 5 5
2 5 5 5 6 5 5 1 1 1 0 0 0 0 0 0 1 1 1 1 2 0 0 0 0 1 1 1 1 1 5 5
1 5 3 5 5 5 5 5 1 1 0 0 1 0 0 0 1 1 1 1 1 0 0 0 0 1 1 5 5 5 5 5
1 5 4 5 5 5 5 6 1 1 0 0 0 0 0 0 1 1 1 1 1 0 0 0 0 1 5 5 5 5 6 5
5 5 5 5 5 3 5 5 5 5 5 5 0 0 0 1 1 1 1 1 1 1 0 0 0 0 0 0 0 0 0 0
6 5 5 5 5 4 5 5 5 5 5 6 5 0 0 1 1 1 1 1 1 1 0 0 0 0 0 0 0 0 0 5
5 5 5 5 5 5 5 6 1 1 1 0 0 0 0 1 1 1 1 1 1 1 0 0 0 0 0 0 0 0 5 5
0 5 5 6 5 5 5 5 1 1 1 0 0 0 0 0 0 0 0 0 0 0 0 0 0 0 0 0 0 5 5 5
5 5 5 5 5 5 5 5 1 1 0 0 1 1 1 0 0 0 0 0 0 0 1 0 0 0 0 0 0 5 6 5
6 5 1 1 1 1 1 0 0 1 0 0 1 1 1 1 1 1 1 1 0 0 0 2 2 0 2 0 5 6 5 5
1 1 1 1 1 1 1 1 1 1 0 0 0 1 0 0 0 1 1 1 0 0 0 0 0 0 0 0 5 6 6 5
0 1 1 1 1 1 1 1 0 0 0 0 0 1 0 0 0 0 0 0 0 0 0 0 0 0 0 5 5 5 5 5
0 1 1 1 1 1 1 1 0 0 0 0 0 0 0 0 0 0 0 0 0 0 0 0 5 5 6 5 5 5 5 5
2 2 2 2 2 2 2 2 2 2 2 2 2 2 2 2 2 2 2 2 2 2 2 2 5 5 5 5 5 5 5 5
1 1 1 1 1 1 1 1 1 1 1 1 1 1 1 1 1 1 1 1 1 1 1 1 5 6 5 5 5 5 5 5