50 50
0 0 0 0 0 0 0 0 0 0 0 0 0 0 0 0 0 0 0 0 0 0 0 0 0 0 0 0 0 0 0 0 0 0 0 0 0 0 0 0 0 0 0 0 0 0 0 0 0 0
0 0 0 0 0 0 0 0 0 0 0 0 0 0 0 0 0 0 0 0 0 0 0 0 0 0 0 0 0 0 0 0 0 0 0 0 0 0 0 0 0 0 0 0 0 0 0 0 0 0
0 0 0 0 0 0 0 0 0 0 0 0 0 0 0 0 0 0 0 0 0 0 0 0 0 0 0 0 0 0 0 0 0 0 0 0 0 0 0 0 0 0 0 0 0 0 0 0 0 0
0 0 0 0 0 0 0 0 0 0 0 0 0 0 0 0 0 0 0 0 0 0 0 0 0 0 0 0 0 0 0 0 0 0 0 0 0 0 0 0 0 0 0 0 0 0 0 0 0 0
0 0 0 0 0 0 0 0 0 0 0 0 0 0 0 0 0 0 0 0 0 0 0 0 0 0 0 0 0 0 0 0 0 0 0 0 0 0 0 0 0 0 0 0 0 0 0 0 0 0
0 0 0 0 1 1 1 1 1 1 1 1 1 1 0 0 0 0 0 2 2 2 2 2 0 0 0 0 0 0 0 0 0 0 0 0 0 0 0 0 0 0 0 0 0 0 0 0 0 0
0 0 0 1 1 1 1 1 1 1 1 1 1 1 1 0 0 0 0 2 2 2 2 2 0 0 0 0 0 0 0 2 0 0 0 0 0 0 0 0 0 0 0 0 0 0 2 2 0 0
0 0 1 1 1 1 1 1 1 1 1 1 1 1 1 0 0 0 2 2 2 2 2 2 2 0 0 0 0 0 2 0 0 0 0 0 0 0 0 0 0 0 0 0 0 0 2 2 0 0
0 0 1 1 1 1 1 1 1 1 1 1 1 1 1 1 0 0 0 2 2 2 2 0 0 0 0 0 0 2 2 0 0 0 0 0 0 0 0 0 0 0 0 0 2 2 2 2 0 0
0 0 1 1 1 1 1 1 1 1 1 1 1 1 1 1 0 0 0 0 2 2 0 0 0 0 0 0 0 2 0 0 0 0 0 1 1 1 1 1 0 0 0 0 2 2 2 0 0 0
0 0 0 1 1 1 1 1 1 1 1 1 1 1 1 1 0 0 0 0 0 0 0 0 0 0 0 0 0 2 0 0 0 0 1 1 1 1 1 1 0 0 0 0 0 2 2 0 0 0
0 0 0 0 1 1 1 1 1 1 1 1 1 1 1 1 0 0 0 0 0 0 0 0 0 0 0 0 0 0 0 0 0 0 1 1 1 1 1 1 1 0 0 0 0 0 0 0 0 0
0 2 0 0 0 0 1 1 1 1 1 1 1 1 1 0 0 0 0 0 0 0 0 0 0 0 0 0 0 0 0 0 0 1 1 1 1 1 1 1 1 0 0 0 0 0 0 0 0 0
0 2 0 0 0 1 1 1 1 5 5 5 1 1 1 1 0 0 0 0 0 0 0 0 0 0 0 0 0 0 0 0 0 1 1 1 1 1 1 1 1 0 0 0 0 0 0 0 0 0
0 2 0 0 0 1 1 1 1 5 6 5 1 1 1 1 1 0 0 0 0 0 0 0 0 0 0 0 0 0 0 0 0 1 1 1 1 1 1 1 1 0 0 0 0 0 0 0 0 0
0 2 0 0 0 1 1 1 1 5 5 5 5 1 1 1 1 1 0 0 0 1 0 0 0 0 0 0 0 0 0 0 0 1 1 1 1 1 1 1 0 0 0 0 0 0 0 0 0 0
0 2 0 0 0 1 1 1 5 5 5 5 5 5 1 1 1 1 1 0 0 0 0 0 0 0 0 0 0 0 0 0 0 0 0 1 1 1 1 0 0 0 0 0 0 0 0 0 0 0
0 0 0 0 0 1 1 1 5 3 0 0 0 0 0 0 1 1 1 1 1 1 0 1 1 0 0 0 0 0 2 2 0 0 0 0 0 0 0 0 0 0 0 0 0 0 0 0 0 0
0 0 0 0 0 1 1 1 5 4 0 2 0 0 0 0 0 0 1 1 1 1 0 0 1 0 0 0 2 2 2 2 0 0 0 0 0 0 0 0 0 0 0 0 0 0 0 0 0 0
0 0 0 0 0 1 1 1 6 5 0 2 2 0 0 0 0 0 0 0 0 0 0 0 1 0 0 0 2 2 2 0 0 0 0 0 0 0 0 0 0 0 0 0 0 0 0 0 0 0
0 0 0 0 1 1 1 1 5 5 5 0 2 0 0 0 2 0 0 1 0 0 0 0 1 0 0 0 0 0 0 0 0 0 0 0 0 0 0 0 0 0 0 0 0 0 0 0 0 0
0 0 1 1 1 1 1 1 1 5 5 0 2 0 0 0 2 2 2 2 0 0 1 0 0 0 0 0 0 2 2 0 0 0 0 0 0 0 0 0 0 0 0 0 0 0 0 0 0 0
0 1 1 1 1 1 1 1 5 5 5 5 5 3 0 0 2 2 2 2 0 0 0 0 0 0 0 0 0 0 0 0 0 0 0 0 0 0 0 0 0 2 2 2 2 0 0 0 0 0
0 1 1 1 1 0 1 1 5 5 5 5 5 4 0 2 2 2 2 2 0 0 0 0 0 0 0 0 0 0 0 0 0 0 0 0 0 0 0 0 2 2 2 2 2 0 0 0 0 0
0 1 1 1 0 1 1 1 5 1 1 1 1 1 2 2 2 2 2 2 2 2 0 0 0 0 5 5 5 5 0 0 0 0 0 0 0 0 0 0 2 2 2 2 0 0 0 0 0 0
0 1 1 1 1 0 1 1 5 5 1 1 1 1 2 2 2 2 2 2 2 0 0 0 5 5 5 5 0 0 0 0 2 0 0 0 0 0 0 0 2 2 2 2 0 0 0 0 0 0
0 1 1 1 5 1 1 1 5 1 0 0 0 0 0 0 2 0 2 2 0 0 0 5 5 5 5 5 0 0 0 2 2 2 0 0 0 0 0 0 0 0 0 0 0 0 0 2 0 0
0 1 1 1 5 1 1 1 1 1 0 0 0 0 0 0 2 0 0 0 1 1 1 5 5 5 3 5 0 0 0 2 2 2 0 0 0 0 0 0 0 0 0 0 0 0 0 0 0 0
0 1 5 5 5 1 5 1 1 1 1 0 0 0 2 2 2 0 0 0 1 1 1 5 5 5 4 5 5 0 0 0 2 0 0 0 0 0 0 0 0 0 0 0 0 0 0 0 0 0
5 5 6 5 5 5 6 1 1 1 1 0 2 2 2 2 2 2 0 0 0 1 1 3 5 5 5 5 5 0 0 0 0 0 0 0 0 0 2 0 0 0 0 0 0 0 0 0 0 0
5 5 1 1 1 1 1 1 1 0 0 0 0 2 2 2 2 2 0 0 0 1 0 4 5 5 5 5 5 5 0 0 0 0 0 0 0 0 0 0 0 0 0 0 0 0 0 0 0 0
5 5 1 1 1 1 1 1 0 0 0 0 0 0 2 2 2 0 0 0 0 1 0 5 5 5 5 5 0 2 0 0 0 0 0 0 0 0 0 0 0 0 0 0 0 0 0 0 0 0
5 1 1 1 1 1 1 1 1 1 1 1 1 0 2 2 2 2 0 0 0 0 0 0 0 0 0 0 2 2 2 0 1 1 0 0 0 0 0 0 0 0 0 0 1 1 0 0 0 0
5 5 1 1 1 1 5 5 5 5 5 5 0 0 0 2 0 0 0 0 0 0 1 0 0 0 0 2 2 2 2 0 1 0 0 0 0 0 0 0 1 1 0 0 1 0 0 0 0 0
5 5 1 1 1 1 1 1 1 5 6 5 0 0 0 2 0 0 0 0 0 0 0 0 0 0 0 2 2 2 0 0 1 0 0 0 0 0 0 1 0 1 1 1 0 0 0 0 0 0
5 5 1 0 0 0 1 1 1 5 5 5 5 0 0 0 0 0 0 0 0 0 0 0 0 0 0 0 0 0 0 1 1 0 0 0 0 0 1 1 0 0 0 0 0 0 2 0 0 0
5 5 0 0 0 0 0 1 1 5 5 5 5 5 5 0 1 1 1 1 2 0 0 0 0 0 0 0 0 0 1 1 0 0 0 0 0 0 0 0 0 0 0 0 0 2 2 2 0 0
5 1 1 1 1 0 0 0 1 5 5 5 5 5 5 0 1 1 1 1 1 0 0 0 0 0 0 0 0 1 1 1 1 0 0 0 0 0 0 0 0 0 0 0 2 2 2 2 0 0
1 1 1 1 1 1 1 1 1 5 5 5 5 0 0 0 1 1 1 1 1 0 0 0 0 0 0 0 1 1 1 1 1 1 0 0 0 0 0 0 0 0 0 0 2 2 2 0 0 0
1 1 1 1 0 1 1 1 0 1 0 5 5 0 0 1 1 1 1 1 1 1 0 0 2 0 0 0 1 1 1 1 1 1 0 0 0 0 0 0 2 0 0 0 0 0 0 0 0 0
0 1 1 0 0 1 1 1 1 0 0 0 0 0 0 1 1 1 1 1 1 1 0 0 0 0 0 0 1 1 1 1 1 1 0 0 0 0 0 0 0 0 0 0 0 1 1 0 0 0
0 0 0 0 0 0 0 0 1 1 1 0 0 0 0 1 1 1 1 1 1 1 0 0 0 0 0 0 1 1 1 1 1 0 0 0 0 0 0 0 0 0 0 1 1 0 1 0 0 0
0 0 0 0 0 0 0 0 1 1 1 0 0 0 0 0 0 0 0 0 0 0 0 0 0 0 0 0 0 0 0 0 0 0 0 0 0 0 0 0 1 1 1 1 0 0 1 0 0 0
0 0 1 1 1 1 1 1 1 1 0 0 1 1 1 0 0 0 0 0 0 0 1 0 0 0 0 0 0 0 0 0 0 0 0 0 0 0 0 0 0 0 0 0 0 0 0 0 0 0
1 1 1 1 1 1 1 0 0 1 0 0 1 1 1 1 1 1 1 1 0 0 0 0 0 0 0 0 0 0 0 0 2 0 0 0 0 0 0 0 0 0 0 0 0 0 0 0 0 0
1 1 1 1 1 1 1 1 1 1 0 0 0 1 0 0 0 1 1 1 0 0 0 0 0 0 2 0 0 0 0 0 0 0 0 0 0 0 0 0 0 0 0 0 0 0 0 0 0 0
0 1 1 1 1 1 1 1 0 0 0 0 0 1 0 0 0 0 0 0 0 0 0 0 0 0 0 0 0 0 0 0 0 0 0 0 0 0 0 0 0 0 0 0 0 0 0 0 0 0
0 1 1 1 1 1 1 1 0 0 0 0 0 0 0 0 0 0 0 0 0 0 0 0 0 0 0 0 0 0 0 0 0 0 0 0 0 0 0 0 0 0 0 0 0 0 0 0 0 0
2 2 2 2 2 2 2 2 2 2 2 2 2 2 2 2 2 2 2 2 2 2 2 2 2 2 2 2 2 2 2 2 2 2 2 2 2 2 2 2 2 2 2 2 2 2 2 2 2 2
1 1 1 1 1 1 1 1 1 1 1 1 1 1 1 1 1 1 1 1 1 1 1 1 1 1 1 1 1 1 1 1 1 1 1 1 1 1 1 1 1 1 1 1 1 1 1 1 1 1